#########################
#@.............&.###&..##
#...###..##..#.#...#...#
#######....#.#.###.###.#
#....#####.....#.&.....##
#.#.@#...#...#.#.###....#
#.#..#.&.##.#.#.#.##..###
#.#..#...#.&.#.#.......#
#..####.##########.&###.#
#................###.&###
#######.###.#.###..#.#####
#&......#&..#&..........#
#########################