########################
#@.......#.............@#
#.######.#.###########..#
#.#...&#.#.#.&.......#..#
#.#.##.#.#.#.#####.#.#..#
#.#..#.#&#.#.#..&#.#.#..#
#.#..#.#.#.#.#.###.#.#..#
#.#..#.#.#.#.#.....#.#..#
#.#..#.#.#.#&#.....#.#..#
#.#..#.#.#.########..#..#
#.#.&#...#.......&#&.#&.#
#.##################.#..#
#....&.................#
########################