########################
#@#&..#&...##&........@#
#.#.#.#.#..##.##########
#.#.#.#.#..##.#&.......#
#.#.#.#.#..##.#.######.#
#.#.#.#.#..##.#.#....#.#
#.#.#.#.#..##.#.#.##.#.#
#.#.#.#.#..##.#.#.&#.#.#
#.#.#.#.#..##.#.####.#.#
#.#.#.#.#..##.#.....&#.#
#.#.#.#.#..##.########.#
#&..#..&#.&##.........&#
########################